11111111111
1C000000E11
10000000001
10000PC0001
100000000C1
11111111111