11111111111111111111111111111111111111111111111
1E00000000000000000000000000000C000000000000001
10000000000000000000000000000000000000000000001
10100000001011111110100000010111100011111111101
10110000011010000000100000010100010000001000001
101010001P1010000000100000010100001000001000001
10100101001011111110111111110100001000001000001
10100010001010000000100000010100001000001000001
10100000001010000000100000010100010000001000001
10100000001011111110100000010111100011111111101
10000000000000000000000000000000000000000000001
11111111111111111111111111111111111111111111111